################################################# 
||................ ................ ........   || 
||.%%%%%%%%%%%%%   .  %%%%%%%%%%%%            .|| 
||.               |.|      ....................|| 
||.   %%%%        |.|     .........%%%%        || 
||. %%%%%%%%%%    |.| .........................|| 
||.               |.|             .            || 
||.%%%%%%%%%%%%%   .   %%%%%%%%%%%%%%%%%%%%    || 
||............... .................            || 
||.               | |..........................|| 
|| ..%%%%%%%%%... . ...%%%%%%%%%%%%%%%%        || 
||.               |.| .........................|| 
||............... |.|    %%%%%%%%%%%%%%%%%%%   || 
||. ............  |.| .........................|| 
||.%%%%%%%%%%%%%   .  %%%%%%%%%%%%%%%%%        || 
||................ ...............  .......... || 
################################################# 
