################################################# 
||                                             || 
||                                             || 
||                | |                          || 
||                | |                          || 
||        .       | |                          || 
||                | |                          || 
||                                             || 
||                              .              || 
||                | |       .                  || 
||                             .               || 
||                | |                          || 
||                | |                          || 
||                | |                          || 
||                                             || 
||                                             || 
################################################# 
