########################################### 
||    ...............................    || 
||    ...............|||.............    || 
||||..................|................|||| 
||                                       || 
||                                       || 
||                                       || 
||                                       || 
||                                       || 
||                                       || 
||                                       || 
||                                       || 
||                                       || 
||                                       || 
||                                       || 
||                                       || 
||                                       || 
||                                       || 
||||..................|................|||| 
||   ................|||...............  || 
||.......................................|| 
########################################### 
